A	AH
A	EY
ABIDE	AH B AY D
ABLE	EY B AH L
ABOUT	AH B AW T
ABOVE	AH B AH V
ABSURD	AH B S ER D
ACADEMIC	AE K AH D EH M IH K
ACCENT	AE K S EH N T
ACCENT	AH K S EH N T
ACCIDENT	AE K S AH D AH N T
ACCLAIM	AH K L EY M
ACCOMPLISH	AH K AA M P L IH SH
ACCOMPLISHED	AH K AA M P L IH SH T
ACCORDION	AH K AO R D IY AH N
ACHE	EY K
ACHES	EY K S
ACROSS	AH K R AO S
ACTING	AE K T IH NG
ACTIVITIES	AE K T IH V AH T IY Z
ACTIVITIES	AE K T IH V IH T IY Z
ACTRESS	AE K T R AH S
ACTS	AE K S
ACTS	AE K T S
ACTUALLY	AE K CH L IY
ACTUALLY	AE K CH UW AH L IY
ACTUALLY	AE K SH AH L IY
ADD	AE D
ADDED	AE D AH D
ADDED	AE D IH D
ADDITION	AH D IH SH AH N
ADVANTAGE	AE D V AE N T IH JH
ADVANTAGE	AH D V AE N T IH JH
ADVISEMENT	AH D V AY Z M AH N T
AFTER	AE F T ER
AGAIN	AH G EH N
AGAIN	AH G EY N
AH	AA
AHEAD	AH HH EH D
AID	EY D
AIL	EY L
AIR	EH R
ALFALFA	AE L F AE L F AH
ALIMONY	AE L AH M OW N IY
ALL	AO L
ALLOW	AH L AW
ALONE	AH L OW N
ALPHA	AE L F AH
ALSO	AO L S OW
ALTHOUGH	AO L DH OW
ALUMINUM	AH L UW M AH N AH M
ALWAYS	AO L W EY Z
ALWAYS	AO L W IY Z
AM	AE M
AM	EY EH M
AMBIDEXTROUS	AE M B AH D EH K S T R AH S
AMBIDEXTROUS	AE M B IH D EH K S T R AH S
AN	AE N
AN	AH N
ANCIENT	EY N CH AH N T
ANCIENT	EY N SH AH N T
AND	AE N D
AND	AH N D
ANNOYING	AH N OY IH NG
ANSWERS	AE N S ER Z
ANY	EH N IY
ANYBODY	EH N IY B AH D IY
ANYWHERE	EH N IY HH W EH R
ANYWHERE	EH N IY W EH R
APARTMENTS	AH P AA R T M AH N T S
APE	EY P
APPEALING	AH P IY L IH NG
APPETIZERS	AE P AH T AY Z ER Z
APPLIANCES	AH P L AY AH N S AH Z
APPLIANCES	AH P L AY AH N S IH Z
APPRECIATED	AH P R IY SH IY EY T IH D
APPROACHED	AH P R OW CH T
APRONS	EY P R AH N Z
APTITUDE	AE P T AH T UW D
ARE	AA R
ARE	ER
AREA	EH R IY AH
AREN'T	AA R AH N T
AREN'T	AA R N T
ARGUE	AA R G Y UW
ARM	AA R M
AROUND	ER AW N
AROUND	ER AW N D
ARTISTS	AA R T IH S T S
AS	AE Z
AS	EH Z
ASH	AE SH
ASK	AE S K
ASKED	AE S K T
ASKED	AE S T
ASSAULTS	AH S AO L T S
AT	AE T
ATE	EY T
ATHLETIC	AE TH L EH T IH K
ATTENDANCE	AH T EH N D AH N S
ATTENTION	AH T EH N SH AH N
ATTITUDE	AE T AH T UW D
AUCTION	AA K SH AH N
AUCTION	AO K SH AH N
AVAILABLE	AH V EY L AH B AH L
AWAY	AH W EY
BACK	B AE K
BAD	B AE D
BADGER	B AE JH ER
BAG	B AE G
BAGPIPES	B AE G P AY P S
BALL	B AO L
BAN	B AE N
BANANA	B AH N AE N AH
BANK	B AE NG K
BANKERS	B AE NG K ER Z
BANKS	B AE NG K S
BARB'S	B AA R B Z
BARN	B AA R N
BASEBALL	B EY S B AO L
BASH	B AE SH
BASKETBALL	B AE S K AH T B AO L
BAT	B AE T
BAY	B EY
BE	B IY
BEACH	B IY CH
BEAM	B IY M
BEAR	B EH R
BEARD	B IH R D
BEAST	B IY S T
BEAT	B IY T
BEAUTY	B Y UW T IY
BECAME	B IH K EY M
BECAME	B IY K EY M
BECAUSE	B IH K AA Z
BECAUSE	B IH K AH Z
BECAUSE	B IH K AO Z
BED	B EH D
BEEF	B IY F
BEEN	B AH N
BEEN	B IH N
BEEP	B IY P
BEFORE	B IH F AO R
BEFORE	B IY F AO R
BEG	B EH G
BEGIN	B IH G IH N
BEHAVIOR	B IH HH EY V Y ER
BEING	B IY IH NG
BELL	B EH L
BEND	B EH N D
BENDER	B EH N D ER
BENEFITS	B EH N AH F IH T S
BEST	B EH S T
BETA	B EY T AH
BETTER	B EH T ER
BIBLICAL	B IH B L AH K AH L
BIBLICAL	B IH B L IH K AH L
BIDDING	B IH D IH NG
BIG	B IH G
BILL	B IH L
BIN	B IH N
BIT	B IH T
BITTEN	B IH T AH N
BITTER	B IH T ER
BLACK	B L AE K
BLAZE	B L EY Z
BLEND	B L EH N D
BLEW	B L UW
BLOAT	B L OW T
BLOW	B L OW
BOAST	B OW S T
BOAT	B OW T
BOG	B AA G
BOG	B AO G
BONGOS	B AA NG G OW Z
BOOK	B UH K
BOOKS	B UH K S
BOONE	B UW N
BOOT	B UW T
BOOTH	B UW TH
BOOTHS	B UW TH S
BORN	B AO R N
BOTH	B OW TH
BOUGHT	B AA T
BOUGHT	B AO T
BOUNCE	B AW N S
BOWL	B OW L
BOX	B AA K S
BRACELET	B R EY S L AH T
BRAIN	B R EY N
BRAWN	B R AO N
BREAD	B R EH D
BRIAR	B R AY ER
BRIGHT	B R AY T
BROCCOLI	B R AA K AH L IY
BROCCOLI	B R AA K L IY
BROTHER'S	B R AH DH ER Z
BROTHERS	B R AH DH ER Z
BROUGHT	B R AO T
BROWN	B R AW N
BUBBLE	B AH B AH L
BUG	B AH G
BUILD	B IH L D
BULL	B UH L
BUMPER	B AH M P ER
BUN	B AH N
BUNCH	B AH N CH
BUREAUCRACY	B Y UH R AA K R AH S IY
BURN	B ER N
BURNER	B ER N ER
BUS	B AH S
BUST	B AH S T
BUT	B AH T
BUTTONS	B AH T AH N Z
BY	B AY
CABLE	K EY B AH L
CAKE	K EY K
CAKES	K EY K S
CALICO	K AE L AH K OW
CALL	K AO L
CALLED	K AO L D
CALLS	K AO L Z
CAN	K AE N
CAN	K AH N
CAN'T	K AE N T
CANNOT	K AE N AA T
CANNOT	K AH N AA T
CANTEEN	K AE N T IY N
CAR	K AA R
CAREFULLY	K EH R F AH L IY
CARL	K AA R L
CARRIED	K AE R IY D
CARRIED	K EH R IY D
CARRY	K AE R IY
CARRY	K EH R IY
CARS	K AA R Z
CARS	K AA Z
CART	K AA R T
CASES	K EY S AH Z
CASES	K EY S IH Z
CASH	K AE SH
CASUALLY	K AE ZH AH W AH L IY
CASUALLY	K AE ZH W AH L IY
CAT	K AE T
CATASTROPHIC	K AE T AH S T R AA F IH K
CATCH	K AE CH
CAUGHT	K AA T
CAUGHT	K AO T
CAULIFLOWER	K AA L AH F L AW ER
CAUSED	K AA Z D
CAUSED	K AO Z D
CELEBRATE	S EH L AH B R EY T
CEMENT	S AH M EH N T
CEMENT	S IH M EH N T
CENTER	S EH N ER
CENTER	S EH N T ER
CHABLIS	SH AH B L IY
CHAIR	CH EH R
CHALLENGE	CH AE L AH N JH
CHANGE	CH EY N JH
CHAP	CH AE P
CHARLIE	CH AA R L IY
CHARLIE'S	CH AA R L IY Z
CHARM	CH AA R M
CHECK	CH EH K
CHEER	CH IH R
CHEESE	CH IY Z
CHILDREN	CH IH L D R AH N
CHIN	CH IH N
CHIP	CH IH P
CHOCOLATE	CH AO K L AH T
CHOOSE	CH UW Z
CHOP	CH AA P
CHOSE	CH OW Z
CHOWDER	CH AW D ER
CITY	S IH T IY
CLAIM	K L EY M
CLAMS	K L AE M Z
CLASSICAL	K L AE S IH K AH L
CLEAN	K L IY N
CLEAR	K L IH R
CLIFF'S	K L IH F S
CLINGS	K L IH NG Z
COAST	K OW S T
COAT	K OW T
COCONUT	K OW K AH N AH T
CODE	K OW D
COLD	K OW L D
COLLEGES	K AA L IH JH IH Z
COLORFUL	K AH L ER F AH L
COMBED	K OW M D
COME	K AH M
COMING	K AH M IH NG
COMMON	K AA M AH N
COMMUNITY	K AH M Y UW N AH T IY
COMMUNITY	K AH M Y UW N IH T IY
COMPANY	K AH M P AH N IY
COMPETITORS	K AH M P EH T AH T ER Z
COMPETITORS	K AH M P EH T IH T ER Z
COMPLIANCE	K AH M P L AY AH N S
COMPOUNDED	K AH M P AW N D AH D
COMPOUNDED	K AH M P AW N D IH D
CONFIDENCE	K AA N F AH D AH N S
CONFIRMATION	K AA N F ER M EY SH AH N
CONSCIOUS	K AA N SH AH S
CONSERVE	K AH N S ER V
CONSTRUCTION	K AH N S T R AH K SH AH N
CONTAINED	K AH N T EY N D
CONTAINS	K AH N T EY N Z
CONTINENTAL	K AA N T AH N EH N AH L
CONTINENTAL	K AA N T AH N EH N T AH L
CONTRACT	K AA N T R AE K T
CONTRACT	K AH N T R AE K T
CONTRAST	K AA N T R AE S T
CONTRAST	K AH N T R AE S T
CONTRIBUTIONS	K AA N T R AH B Y UW SH AH N Z
CONVERGE	K AH N V ER JH
CORK	K AO R K
CORN	K AO R N
COSTUMES	K AA S T UW M Z
COULD	K UH D
COUPE	K UW P
COURT	K AO R T
COVERED	K AH V ER D
COVERS	K AH V ER Z
CRACKED	K R AE K T
CRAWL	K R AO L
CREAM	K R IY M
CREATURE	K R IY CH ER
CREDIT	K R EH D AH T
CREDIT	K R EH D IH T
CRITICAL	K R IH T IH K AH L
CRUCIFIED	K R UW S AH F AY D
CUBIC	K Y UW B IH K
CURTAINS	K ER T AH N Z
CUT	K AH T
CUTBACKS	K AH T B AE K S
CUTTING	K AH T IH NG
CYCLE	S AY K AH L
DAD	D AE D
DAGGER	D AE G ER
DAILY	D EY L IY
DAMAGE	D AE M AH JH
DAMAGE	D AE M IH JH
DAMAGED	D AE M AH JH D
DAMAGED	D AE M IH JH D
DAMP	D AE M P
DANCE	D AE N S
DARK	D AA R K
DARN	D AA R N
DART	D AA R T
DASH	D AE SH
DAY	D EY
DEAD	D EH D
DEADLINE	D EH D L AY N
DEAL	D IY L
DECISION	D IH S IH ZH AH N
DECORATIVE	D EH K R AH T IH V
DEER	D IH R
DEFENSIVE	D IH F EH N S IH V
DEFINITELY	D EH F AH N AH T L IY
DEGREE	D IH G R IY
DEGREES	D IH G R IY Z
DELIGHT	D IH L AY T
DELTA	D EH L T AH
DEMAND	D IH M AE N D
DEPOT	D IY P OW
DEPRESS	D IH P R EH S
DESCRIBE	D IH S K R AY B
DESERVE	D IH Z ER V
DESERVES	D IH Z ER V Z
DESIRE	D IH Z AY ER
DESPERATELY	D EH S P ER AH T L IY
DESPERATELY	D EH S P R AH T L IY
DESSERT	D IH Z ER T
DESTROY	D IH S T R OY
DETAIL	D IH T EY L
DETAIL	D IY T EY L
DIAL	D AY AH L
DIAL	D AY L
DICE	D AY S
DID	D IH D
DIDN'T	D IH D AH N
DIDN'T	D IH D AH N T
DIDN'T	D IH D N T
DIDN'T	D IH N T
DIED	D AY D
DIFFERENT	D IH F ER AH N T
DIFFERENT	D IH F R AH N T
DILL	D IH L
DINNER	D IH N ER
DIPLOMA	D IH P L OW M AH
DIRECTOR	D AY R EH K T ER
DIRECTOR	D ER EH K T ER
DIRECTOR	D IH R EH K T ER
DIRECTOR	D IY R EH K T ER
DIRTY	D ER T IY
DISAPPOINTED	D IH S AH P OY N IH D
DISAPPOINTED	D IH S AH P OY N T IH D
DISAPPOINTING	D IH S AH P OY N IH NG
DISAPPOINTING	D IH S AH P OY N T IH NG
DISCLAIMER	D IH S K L EY M ER
DISCOVER	D IH S K AH V ER
DISCUSSIONS	D IH S K AH SH AH N Z
DISGUISE	D IH S G AY Z
DISHES	D IH SH AH Z
DISHES	D IH SH IH Z
DISLIKES	D IH S L AY K S
DISPLAY	D IH S P L EY
DISPLAYED	D IH S P L EY D
DISTRESS	D IH S T R EH S
DISTRICTS	D IH S T R IH K T S
DIVORCED	D IH V AO R S T
DO	D UW
DOCK	D AA K
DOCKS	D AA K S
DOCTORS	D AA K T ER Z
DOESN'T	D AH Z AH N
DOESN'T	D AH Z AH N T
DOG	D AO G
DOING	D UW IH NG
DOLPHINS	D AA L F AH N Z
DON'T	D OW N
DON'T	D OW N T
DONE	D AH N
DORMITORIES	D AO R M AH T AO R IY Z
DOT	D AA T
DOUBLE	D AH B AH L
DOUGH	D OW
DOWN	D AW N
DREAD	D R EH D
DRENCHED	D R EH N CH T
DRESS	D R EH S
DRESSES	D R EH S AH Z
DRESSES	D R EH S IH Z
DRIFT	D R IH F T
DRIFTS	D R IH F T S
DRIVEN	D R IH V AH N
DROOP	D R UW P
DRUGS	D R AH G Z
DUCK	D AH K
DUG	D AH G
DUSK	D AH S K
EACH	IY CH
EARLY	ER L IY
EARN	ER N
EASE	IY Z
EASTERN	IY S T ER N
EASY	IY Z IY
EAT	IY T
ECHO	EH K OW
ECONOMIC	EH K AH N AA M IH K
ECONOMIC	IY K AH N AA M IH K
ECONOMY	IH K AA N AH M IY
ECONOMY	IY K AA N AH M IY
EDUCATION	EH JH AH K EY SH AH N
EDUCATION	EH JH Y UW K EY SH AH N
EIGHT	EY T
EITHER	AY DH ER
EITHER	IY DH ER
ELDERLY	EH L D ER L IY
ELSE	EH L S
EMBER	EH M B ER
EMPTY	EH M P T IY
EMPTY	EH M T IY
ENABLING	EH N EY B AH L IH NG
ENABLING	IH N EY B AH L IH NG
ENABLING	IH N EY B L IH NG
END	EH N D
ENTERTAINING	EH N ER T EY N IH NG
ENTERTAINING	EH N T ER T EY N IH NG
ENTIRE	IH N T AY ER
EPISODE	EH P AH S OW D
EPISODE	EH P IH S OW D
EQUIPMENT	IH K W IH P M AH N T
ERROR	EH R ER
ETIQUETTE	EH T AH K AH T
EVACUATE	IH V AE K Y AH EY T
EVACUATE	IY V AE K Y AH EY T
EVEN	IY V IH N
EVENING	IY V N IH NG
EVENTUALLY	IH V EH N CH AH W AH L IY
EVENTUALLY	IH V EH N SH AH L IY
EVENTUALLY	IY V EH N CH AH W AH L IY
EVENTUALLY	IY V EH N SH AH L IY
EVER	EH V ER
EVERY	EH V ER IY
EVERY	EH V R IY
EVERYTHING	EH V R IY TH IH NG
EXACTLY	IH G Z AE K T L IY
EXAM	IH G Z AE M
EXCELLENT	EH K S AH L AH N T
EXCEPT	IH K S EH P T
EXCITEMENT	IH K S AY T M AH N T
EXCLUDED	IH K S K L UW D AH D
EXCLUDED	IH K S K L UW D IH D
EXISTING	IH G Z IH S T IH NG
EXPECT	IH K S P EH K T
EXPECTED	IH K S P EH K T AH D
EXPECTED	IH K S P EH K T IH D
EXPECTS	IH K S P EH K S
EXPECTS	IH K S P EH K T S
EXPENSIVE	IH K S P EH N S IH V
EXPERIENCE	IH K S P IH R IY AH N S
EXPERIMENT	IH K S P EH R AH M AH N T
EXPERIMENTAL	IH K S P EH R IH M EH N AH L
EXPERIMENTAL	IH K S P EH R IH M EH N T AH L
EXPERIMENTAL	IH K S P ER M EH N AH L
EXPERIMENTAL	IH K S P ER M EH N T AH L
EXPLORE	IH K S P L AO R
EYES	AY Z
FABLE	F EY B AH L
FACT	F AE K T
FAIL	F EY L
FAILS	F EY L Z
FAIR	F EH R
FALL	F AA L
FALL	F AO L
FAMILIES	F AE M AH L IY Z
FAMILIES	F AE M L IY Z
FAMILY	F AE M AH L IY
FAMILY	F AE M L IY
FANS	F AE N Z
FARM	F AA R M
FAST	F AE S T
FAT	F AE T
FATE	F EY T
FATHERS	F AA DH ER Z
FAVOR	F EY V ER
FEAR	F IH R
FED	F EH D
FEE	F IY
FEED	F IY D
FEEL	F IY L
FEELING	F IY L IH NG
FEET	F IY T
FELL	F EH L
FENDER	F EH N D ER
FEW	F Y UW
FIELD	F IY L D
FIERCEST	F IH R S AH S T
FIGURES	F IH G Y ER Z
FILE	F AY L
FILL	F IH L
FINAL	F AY N AH L
FIND	F AY N D
FINED	F AY N D
FINGER	F IH NG G ER
FIRE	F AY ER
FIRE	F AY R
FIRST	F ER S T
FISH	F IH SH
FIT	F IH T
FITTING	F IH T IH NG
FIVE	F AY V
FLEECY	F L IY S IY
FLICKER	F L IH K ER
FLIMSY	F L IH M Z IY
FLOOR	F L AO R
FLOORS	F L AO R Z
FLOWERED	F L AW ER D
FLOWERS	F L AW ER Z
FLOWING	F L OW IH NG
FLYING	F L AY IH NG
FOAM	F OW M
FOE	F OW
FOIL	F OY L
FOLD	F OW L D
FOOD	F UW D
FOOL	F UW L
FOR	F AO R
FOR	F ER
FOR	F R ER
FORCE	F AO R S
FORGERY	F AO R JH ER IY
FORK	F AO R K
FORKS	F AO R K S
FORM	F AO R M
FORMULA	F AO R M Y AH L AH
FORT	F AO R T
FORWARD	F AO R W ER D
FOUND	F AW N D
FOUR	F AO R
FOX	F AA K S
FOXTROT	F AA K S T R AA T
FRAME	F R EY M
FREELY	F R IY L IY
FRESH	F R EH SH
FRIEND	F R EH N D
FRIENDS	F R EH N D Z
FRIENDS	F R EH N Z
FROCK	F R AA K
FROM	F ER M
FROM	F R AH M
FRUIT	F R UW T
FRUSTRATION	F R AH S T R EY SH AH N
FUDGE	F AH JH
FULL	F UH L
FUN	F AH N
FUNDS	F AH N D Z
FUNNEL	F AH N AH L
FURTHER	F ER DH ER
FUTURE	F Y UW CH ER
GABLE	G EY B AH L
GADGET	G AE JH AH T
GAINED	G EY N D
GALLON	G AE L AH N
GALORE	G AH L AO R
GAME	G EY M
GAS	G AE S
GASH	G AE SH
GATHERED	G AE DH ER D
GEESE	G IY S
GENERAL'S	JH EH N ER AH L Z
GENERAL'S	JH EH N R AH L Z
GENTLY	JH EH N T L IY
GEOLOGICAL	JH IY AH L AA JH IH K AH L
GET	G EH T
GET	G IH T
GIFT	G IH F T
GIGGLING	G IH G AH L IH NG
GIGGLING	G IH G L IH NG
GILL	G IH L
GIN	JH IH N
GINGHAM	G IH NG AH M
GIRLS	G ER L Z
GIVING	G IH V IH NG
GLIB	G L IH B
GLITTER	G L IH T ER
GLOBE	G L OW B
GLOW	G L OW
GNAW	N AO
GO	G OW
GOAT	G OW T
GOLD	G OW L D
GOLF	G AA L F
GOLF	G AO L F
GOLFING	G AA L F IH NG
GOLFING	G AO L F IH NG
GONE	G AO N
GOOD	G IH D
GOOD	G UH D
GOOSE	G UW S
GOT	G AA T
GOVERNOR	G AH V ER N ER
GRADES	G R EY D Z
GRADUATION	G R AE JH AH W EY SH AH N
GRADUATION	G R AE JH UW EY SH AH N
GRAIN	G R EY N
GRANDFATHER	G R AE N D F AA DH ER
GRANDFATHER	G R AE N F AA DH ER
GRANDMOTHER	G R AE M AH DH ER
GRANDMOTHER	G R AE N D M AH DH ER
GRANDMOTHER	G R AE N M AH DH ER
GRANGE	G R EY N JH
GRANTS	G R AE N T S
GRAPE	G R EY P
GRAVE	G R EY V
GREASY	G R IY S IY
GREAT	G R EY T
GREATLY	G R EY T L IY
GREG	G R EH G
GREY	G R EY
GRIEVANCES	G R IY V AH N S AH Z
GRIEVANCES	G R IY V AH N S IH Z
GROPE	G R OW P
GROUP	G R UW P
GROW	G R OW
GUARANTEES	G EH R AH N T IY Z
GUARD	G AA R D
GUESS	G EH S
HAD	HH AE D
HAIL	HH EY L
HAIR	HH EH R
HALL	HH AO L
HAM	HH AE M
HAND	HH AE N D
HANDLE	HH AE N D AH L
HANGING	HH AE NG G IH NG
HANGING	HH AE NG IH NG
HARD	HH AA R D
HARK	HH AA R K
HARM	HH AA R M
HARMONIZE	HH AA R M AH N AY Z
HARMS	HH AA R M Z
HARP	HH AA R P
HAS	HH AE Z
HAS	HH AH Z
HASH	HH AE SH
HASTILY	HH EY S T AH L IY
HAT	HH AE T
HATCH	HH AE CH
HATE	HH EY T
HAVE	HH AE V
HAVEN'T	HH AE V AH N
HAVEN'T	HH AE V AH N T
HE	HH IY
HE'LL	HH IY L
HEALTHY	HH EH L TH IY
HEAR	HH IY R
HEART	HH AA R T
HEAT	HH IY T
HELP	HH EH L P
HEM	HH EH M
HER	HH ER
HERE	HH IY R
HID	HH IH D
HIDES	HH AY D Z
HIGH	HH AY
HIGHER	HH AY ER
HIGHWAY	HH AY W EY
HILL	HH IH L
HIM	HH IH M
HIM	IH M
HIMSELF	HH IH M S EH L F
HIRES	HH AY ER Z
HIRES	HH AY R Z
HIRING	HH AY R IH NG
HIS	HH IH Z
HISPANIC	HH IH S P AE N IH K
HISTORY	HH IH S T ER IY
HISTORY	HH IH S T R IY
HITTING	HH IH T IH NG
HOLD	HH OW L D
HOME	HH OW M
HORN	HH AO R N
HORSEBACK	HH AO R S B AE K
HOSPITALS	HH AA S P IH T AH L Z
HOTEL	HH OW T EH L
HOTELS	HH OW T EH L Z
HOUSE	HH AW S
HOUSEHOLD	HH AW S HH OW L D
HOUSING	HH AW Z IH NG
HUGE	HH Y UW JH
HUGE	Y UW JH
HUM	HH AH M
HUMIDITY	HH Y UW M IH D AH T IY
I	AY
I'D	AY D
I'M	AH M
I'M	AY M
I'VE	AY V
ICE	AY S
IDEA	AY D IY AH
IDENTICAL	AY D EH N IH K AH L
IDENTICAL	AY D EH N T IH K AH L
IDIOTIC	IH D IY AA T IH K
IF	IH F
ILLEGAL	IH L IY G AH L
IMMEDIATE	IH M IY D IY AH T
IMMEDIATELY	IH M IY D IY AH T L IY
IMPOSSIBLE	IH M P AA S AH B AH L
IMPRESS	IH M P R EH S
IN	IH N
INCIDENTS	IH N S AH D AH N T S
INCOME	IH N K AH M
INCREASES	IH N K R IY S AH Z
INCREASES	IH N K R IY S IH Z
INDEPENDENT	IH N D IH P EH N D AH N T
INJURED	IH N JH ER D
INJURIES	IH N JH ER IY Z
INK	IH NG K
INNOCENCE	IH N AH S AH N S
INNOCENSE	IH N AH S AH N S
INSTRUCTIONS	IH N S T R AH K SH AH N Z
INSTRUMENTS	IH N S T R AH M AH N T S
INTACT	IH N T AE K T
INTELLIGENCE	IH N T EH L AH JH AH N S
INTO	IH N T AH
INTO	IH N T UW
INVESTMENT	IH N V EH S M AH N T
INVESTMENT	IH N V EH S T M AH N T
IS	IH Z
ISLANDS	AY L AH N D Z
ISSUE	IH SH UW
IT	IH T
IT'S	IH T S
ITEMS	AY T AH M Z
JACKET	JH AE K AH T
JACKET	JH AE K IH T
JAGGED	JH AE G D
JANE	JH EY N
JEALOUSIES	JH EH L AH S IY Z
JIM'S	JH IH M Z
JOB	JH AA B
JOB	JH OW B
JUDGE	JH AH JH
JULIET	JH UW L IY EH T
JUMP	JH AH M P
JUMPS	JH AH M P S
JUNGLE	JH AH NG G AH L
JUST	JH AH S T
JUST	JH IH S T
KAT	K AE T
KEEP	K IY P
KEPT	K AE P T
KEPT	K EH P T
KEY	K IY
KILO	K IH L OW
KIND	K AY N D
KITTEN	K IH T AH N
KITTENS	K IH T AH N Z
KNEE	N IY
KNEW	N UW
KNEW	N Y UW
KNIFE	N AY F
KNITTING	N IH T IH NG
KNOCK	N AA K
KNOT	N AA T
KNOW	N OW
KNOWS	N OW Z
LACED	L EY S T
LACK	L AE K
LACY	L EY S IY
LADLE	L EY D AH L
LAIR	L EH R
LAKE	L EY K
LAMPS	L AE M P S
LANGUAGE	L AE NG G W AH JH
LANGUAGE	L AE NG G W IH JH
LARGE	L AA R JH
LARGEST	L AA R JH AH S T
LAST	L AE S
LAST	L AE S T
LAST	L AO S T
LATER	L EY T ER
LAW	L AA
LAW	L AO
LAWYERS	L AO Y ER Z
LAWYERS	L OY ER Z
LAX	L AE K S
LAY	L EY
LAZY	L EY Z IY
LEAGUE	L IY G
LEAK	L IY K
LEAKS	L IY K S
LEAP	L IY P
LEARNED	L ER N D
LEARNED	L ER N IH D
LEE	L IY
LEFT	L EH F T
LEG	L EH G
LEGISLATION	L EH JH AH S L EY SH AH N
LEGISLATURE	L EH JH AH S L EY CH ER
LEISURE	L EH ZH ER
LEISURE	L IY ZH ER
LEND	L EH N D
LENDER	L EH N D ER
LESS	L EH S
LICK	L IH K
LID	L IH D
LIE	L AY
LIES	L AY Z
LIFE	L AY F
LIFE'S	L AY F S
LIGAMENT	L IH G AH M AH N T
LIGHT	L AY T
LIKE	L AY K
LIKES	L AY K S
LILY	L IH L IY
LIMA	L AY M AH
LIMA	L IY M AH
LIMB	L IH M
LIP	L IH P
LIQUOR	L IH K ER
LISP	L IH S P
LIST	L IH S T
LIT	L IH T
LITTER	L IH T ER
LITTLE	L IH T AH L
LIVELY	L AY V L IY
LIVES	L AY V Z
LIVES	L IH V Z
LIVING	L IH V IH NG
LOAN	L OW N
LOCK	L AA K
LONG	L AO NG
LONGER	L AO NG G ER
LOOK	L UH K
LOOKED	L UH K T
LOOP	L UW P
LOSING	L UW Z IH NG
LOSS	L AO S
LOST	L AO S T
LOT	L AA T
LOT	L AO T
LOTS	L AA T S
LOVE	L AH V
LOVED	L AH V D
LOW	L OW
LOWER	L OW ER
LOYAL	L OY AH L
LUCK	L AH K
LUKE	L UW K
MABEL	M EY B AH L
MACHINERY	M AH SH IY N ER IY
MACHINERY	M AH SH IY N R IY
MADE	M EY D
MAIL	M EY L
MAINTENANCE	M EY N T AH N AH N S
MAINTENANCE	M EY N T N AH N S
MAKE	M EY K
MAKES	M EY K S
MALL	M AO L
MAN'S	M AE N Z
MANDATES	M AE N D EY T S
MANY	M EH N IY
MAP	M AE P
MARRIAGE	M EH R IH JH
MARRIED	M EH R IY D
MARSHMALLOWS	M AA R SH M EH L OW Z
MARVELOUSLY	M AA R V AH L AH S L IY
MASK	M AE S K
MASONRY	M EY S AH N R IY
MASSIVE	M AE S IH V
MAT	M AE T
MAY	M EY
MAYBE	M EY B IY
MAYONNAISE	M EY AH N EY Z
ME	M IY
MEALS	M IY L Z
MEASURED	M EH ZH ER D
MEAT	M IY T
MEATS	M IY T S
MEDICINE	M EH D AH S AH N
MEETING	M IY T IH NG
MEMBER	M EH M B ER
MEN	M EH N
MENU	M EH N Y UW
MERE	M IH R
MET	M EH T
MIKE	M AY K
MILE	M AY L
MILL	M IH L
MILLIONAIRES	M IH L Y AH N EH R Z
MINUS	M AY N AH S
MINUTE	M AY N UW T
MINUTE	M AY N Y UW T
MINUTE	M IH N AH T
MISGUIDED	M IH S G AY D IH D
MISPLACED	M IH S P L EY S T
MISPRINT	M IH S P R IH N T
MISTAKES	M IH S T EY K S
MITTEN	M IH T AH N
MOCK	M AA K
MODERN	M AA D ER N
MOLD	M OW L D
MOLE	M OW L
MOM	M AA M
MONEY	M AH N IY
MORE	M AO R
MORNING	M AO R N IH NG
MOST	M OW S
MOST	M OW S T
MOTHER	M AH DH ER
MUCH	M AH CH
MUCK	M AH K
MUNCH	M AH N CH
MUSEUM	M Y UW Z IY AH M
MUSH	M AH SH
MUSICAL	M Y UW Z IH K AH L
MUSICIANS	M Y UW Z IH SH AH N Z
MUSK	M AH S K
MUST	M AH S T
MUT	M AH T
MUTTERING	M AH T ER IH NG
MY	M AY
MYSELF	M AY S EH L F
MYSTERIOUS	M IH S T IH R IY AH S
NAILED	N EY L D
NAME	N EY M
NANCY'S	N AE N S IY Z
NAP	N AE P
NAVAL	N EY V AH L
NEAR	N IH R
NEARBY	N IH R B AY
NEARLY	N IH R L IY
NEAT	N IY T
NED	N EH D
NEED	N IY D
NEEDED	N IY D AH D
NEEDED	N IY D IH D
NEEDS	N IY D Z
NEGLECT	N AH G L EH K T
NEGLECT	N IH G L EH K T
NEST	N EH S T
NEVER	N EH V ER
NEW	N UW
NEW	N Y UW
NICE	N AY S
NICE	N IY S
NIGHT	N AY T
NINE	N AY N
NINETY-THREE	N AY N T IY TH R IY
NO	N OW
NOBODY	N OW B AA D IY
NOBODY	N OW B AH D IY
NOD	N AA D
NOT	N AA T
NOTCH	N AA CH
NOTED	N OW T AH D
NOTED	N OW T IH D
NOTHING	N AH TH IH NG
NOTICED	N OW T AH S T
NOVEMBER	N OW V EH M B ER
NOW	N AW
NUMBER	N AH M B ER
NUT	N AH T
OBSERVE	AH B Z ER V
OBSTACLES	AA B S T AH K AH L Z
OBTAIN	AH B T EY N
OBTAINING	AH B T EY N IH NG
OCCUR	AH K ER
OCEAN	OW SH AH N
ODD	AA D
OF	AH V
OFF	AO F
OFFENSIVE	AH F EH N S IH V
OFFICIAL	AH F IH SH AH L
OFTEN	AO F AH N
OFTEN	AO F T AH N
OIL	OY L
OILY	OY L IY
OK	OW K EY
OLD	OW L D
OMITTED	OW M IH T AH D
OMITTED	OW M IH T IH D
ON	AA N
ON	AO N
ONE	HH W AH N
ONE	W AH N
ONE'S	W AH N Z
ONLY	OW N L IY
OOZE	UW Z
OPEN	OW P AH N
OR	AO R
OR	ER
ORDER	AO R D ER
ORGAN	AO R G AH N
ORIGINAL	ER IH JH AH N AH L
OSCAR	AO S K ER
OTHER	AH DH ER
OUR	AA R
OUR	AW ER
OUR	AW R
OUT	AW T
OUTDOORS	AW T D AO R Z
OUTGREW	AW T G R UW
OVER	OW V ER
OVERALLS	OW V ER AO L Z
OVERWHELMING	OW V ER HH W EH L M IH NG
OVERWHELMING	OW V ER W EH L M IH NG
OWE	OW
OWL	AW L
OWN	OW N
OWNER	OW N ER
OWNERS	OW N ER Z
PACE	P EY S
PACKAGE	P AE K AH JH
PACKAGE	P AE K IH JH
PAD	P AE D
PAGE	P EY JH
PAID	P EY D
PAIN	P EY N
PAINT	P EY N T
PAINTERS	P EY N ER Z
PAINTERS	P EY N T ER Z
PAINTINGS	P EY N IH NG Z
PAINTINGS	P EY N T IH NG Z
PAIR	P EH R
PALE	P EY L
PANEL	P AE N AH L
PANT	P AE N T
PAPA	P AA P AH
PARK	P AA R K
PART	P AA R T
PARTICIPATE	P AA R T IH S AH P EY T
PARTS	P AA R T S
PAST	P AE S T
PASTE	P EY S T
PAT	P AE T
PAY	P EY
PEACH	P IY CH
PEAS	P IY Z
PECK	P EH K
PEER	P IH R
PEOPLE	P IY P AH L
PERFORMANCE	P ER F AO R M AH N S
PERIOD	P IH R IY AH D
PERSONAL	P ER S IH N IH L
PET	P EH T
PETE	P IY T
PETTICOATS	P EH T IY K OW T S
PETTY	P EH T IY
PHONE	F OW N
PICK	P IH K
PICKPOCKET	P IH K P AA K AH T
PICKPOCKETS	P IH K P AA K AH T S
PICNIC	P IH K N IH K
PIE	P AY
PILE	P AY L
PILL	P IH L
PINK	P IH NG K
PIT	P IH T
PITTING	P IH T IH NG
PLACE	P L EY S
PLACES	P L EY S AH Z
PLACES	P L EY S IH Z
PLANT	P L AE N T
PLAY	P L EY
PLAYED	P L EY D
PLAYERS	P L EY ER Z
PLAYS	P L EY Z
PLEASE	P L IY Z
PLEASED	P L IY Z D
PLEASURE	P L EH ZH ER
PLOT	P L AA T
PLUMBING	P L AH M IH NG
POCKET	P AA K AH T
POCKETS	P AA K AH T S
POLE	P OW L
POND	P AA N D
POOR	P UW R
POPULAR	P AA P Y AH L ER
POPULARITY	P AA P Y AH L EH R AH T IY
POPULATED	P AA P Y AH L EY T AH D
PORCH	P AO R CH
PORCUPINES	P AO R K Y AH P AY N Z
PORK	P AO R K
PORT	P AO R T
PORTRAIT	P AO R T R AH T
POSITION	P AH Z IH SH AH N
POSTDATE	P OW S T D EY T
POSTPONED	P OW S P OW N D
POSTPONED	P OW S T P OW N D
POT	P AA T
POTATOES	P AH T EY T OW Z
PRACTICAL	P R AE K T AH K AH L
PRACTICAL	P R AE K T IH K AH L
PREACH	P R IY CH
PRECIOUS	P R EH SH AH S
PREDICAMENT	P R IH D IH K AH M AH N T
PREDICAMENT	P R IY D IH K AH M AH N T
PREFER	P R AH F ER
PREFER	P R IH F ER
PREFER	P R IY F ER
PREPARED	P R IY P EH R D
PRESCRIBE	P R AH S K R AY B
PRESCRIBE	P R IY S K R AY B
PRESENT	P ER Z EH N T
PRESENT	P R EH Z AH N T
PRESENT	P R IY Z EH N T
PRESERVE	P R AH Z ER V
PRESERVE	P R IH Z ER V
PRESERVE	P R IY Z ER V
PRETTY	P R IH T IY
PREVENTS	P R IH V EH N T S
PREVENTS	P R IY V EH N T S
PRICE	P R AY S
PRIMITIVE	P R IH M AH T IH V
PRIMITIVE	P R IH M IH T IH V
PRIOR	P R AY ER
PROGRAM	P R OW G R AE M
PRONOUNCED	P R AH N AW N S T
PROPER	P R AA P ER
PROPOSED	P R AH P OW Z D
PROSECUTED	P R AA S IH K Y UW T IH D
PROSPECT	P R AA S P EH K T
PROUD	P R AW D
PROVIDES	P R AH V AY D Z
PROVOKED	P R AH V OW K T
PROWLER	P R AW L ER
PUBLIC	P AH B L IH K
PULL	P UH L
PUNCH	P AH N CH
PUPPETS	P AH P AH T S
PUPPETS	P AH P IH T S
PURE	P Y UH R
PUT	P UH T
QUART	K W AO R T
QUEBEC	K W AH B EH K
QUICK	K W IH K
QUICKER	K W IH K ER
QUICKLY	K W IH K L IY
QUITE	K W AY T
QUIVERS	K W IH V ER Z
RACE	R EY S
RACKS	R AE K S
RAG	R AE G
RAGE	R EY JH
RAID	R EY D
RAILROAD'S	R EY L R OW D Z
RAIN	R EY N
RAISINS	R EY Z AH N Z
RAISINS	R EY Z IH N Z
RAKE	R EY K
RAKES	R EY K S
RAMP	R AE M P
RANGE	R EY N JH
RARE	R EH R
RAT	R AE T
RATE	R EY T
RATHER	R AE DH ER
RATHER	R AH DH ER
RATTLE	R AE T AH L
RAVE	R EY V
RAY	R EY
REACH	R IY CH
READ	R EH D
READ	R IY D
READY	R EH D IY
REAL	R IY L
REALLY	R IH L IY
REALLY	R IY L IY
REAP	R IY P
RECEIVED	R AH S IY V D
RECEIVED	R IH S IY V D
RECEIVED	R IY S IY V D
RED	R EH D
RED-HANDED	R EH D HH AE N D AH D
RED-HANDED	R EH D HH AE N D IH D
REEF	R IY F
REEK	R IY K
REFER	R AH F ER
REFER	R IH F ER
REFLECT	R AH F L EH K T
REFLECT	R IH F L EH K T
REFLEXES	R IY F L EH K S AH Z
REGULAR	R EH G Y AH L ER
REGULAR	R EY G Y AH L ER
REGULARLY	R EH G Y AH L ER L IY
REGULATIONS	R EH G Y AH L EY SH AH N Z
RELAXED	R IH L AE K S T
RELAXED	R IY L AE K S T
REMAINS	R IH M EY N Z
REMAINS	R IY M EY N Z
RENTER	R EH N T ER
REPLACE	ER P L EY S
REPLACE	R IY P L EY S
REPORT	R IH P AO R T
REPORT	R IY P AO R T
REPORTED	R IH P AO R T AH D
REPORTED	R IY P AO R T AH D
REPRESS	R IY P R EH S
REQUESTS	R IH K W EH S
REQUESTS	R IH K W EH S T S
REQUESTS	R IY K W EH S
REQUESTS	R IY K W EH S T S
REQUIRED	R IY K W AY ER D
REQUIRED	R IY K W AY R D
REQUIRES	R IY K W AY ER Z
REQUIRES	R IY K W AY R Z
RESEMBLE	R IH Z EH M B AH L
RESEMBLE	R IY Z EH M B AH L
RESERVE	R IH Z ER V
RESERVE	R IY Z ER V
RESPECT	R IH S P EH K T
RESPECT	R IY S P EH K T
REST	R EH S T
RESULTED	R IH Z AH L T IH D
RESULTED	R IY Z AH L T AH D
RESULTED	R IY Z AH L T IH D
RESULTS	R IH Z AH L T S
RESULTS	R IY Z AH L T S
RETIREMENT	R IH T AY ER M AH N T
RETIREMENT	R IY T AY ER M AH N T
RETRACT	R IY T R AE K T
REVIEW	R IY V Y UW
REWARDED	R IH W AO R D IH D
REWARDED	R IY W AO R D AH D
REWARDED	R IY W AO R D IH D
RICH	R IH CH
RID	R IH D
RIDE	R AY D
RIGHT	R AY T
RIP	R IH P
RISE	R AY Z
ROAST	R OW S T
ROBIN	R AA B AH N
ROBIN	R AA B IH N
ROCK	R AA K
ROCKS	R AA K S
RODE	R OW D
ROLL	R OW L
ROMANTIC	R OW M AE N T IH K
ROMEO	R OW M IY OW
ROOM	R UW M
ROOT	R UW T
ROSES	R OW Z IH Z
ROW	R OW
RULED	R UW L D
RUNG	R AH NG
RUST	R AH S T
RUT	R AH T
SABLE	S EY B AH L
SACRIFICE	S AE K R AH F AY S
SADDLE	S AE D AH L
SAID	S EH D
SAIL	S EY L
SAKE	S EY K
SAME	S EY M
SAND	S AE N D
SAP	S AE P
SAT	S AE T
SAVE	S EY V
SAW	S AO
SAWS	S AO Z
SCHOLARS	S K AA L ER Z
SCHOOL	S K UW L
SCHOOLHOUSE	S K UW L HH AW S
SCORCH	S K AO R CH
SCORE	S K AO R
SCREAM	S K R IY M
SCREECH	S K R IY CH
SCREEN	S K R IY N
SCRUBBED	S K R AH B D
SCULPTURE	S K AH L P CH ER
SEA	S IY
SEAM	S IY M
SEAT	S IY T
SEE	S IY
SEED	S IY D
SEEDS	S IY D Z
SEEMED	S IY M D
SEEN	S IY N
SELDOM	S EH L D AH M
SELECT	S AH L EH K T
SELECTED	S AH L EH K T AH D
SELECTED	S AH L EH K T IH D
SELL	S EH L
SENDER	S EH N D ER
SERGEANT	S AA R JH AH N T
SERIOUSLY	S IH R IY AH S L IY
SERVE	S ER V
SERVES	S ER V Z
SERVICE	S ER V AH S
SERVICE	S ER V IH S
SEVEN	S EH V AH N
SEVERAL	S EH V ER AH L
SEVERAL	S EH V R AH L
SEW	S OW
SEWS	S UW Z
SHARE	SH EH R
SHAWL	SH AO L
SHE	SH IY
SHEAR	SH IH R
SHED	SH EH D
SHEEP	SH IY P
SHEER	SH IH R
SHEET	SH IY T
SHELL	SH EH L
SHELLED	SH EH L D
SHELLS	SH EH L Z
SHERIFF	SH EH R AH F
SHERIFF	SH EH R IH F
SHIMMERS	SH IH M ER Z
SHIN	SH IH N
SHIP	SH IH P
SHOES	SH UW Z
SHOOK	SH UH K
SHOOT	SH UW T
SHOP	SH AA P
SHORE	SH AO R
SHORT	SH AO R T
SHORTAGE	SH AO R T AH JH
SHORTAGE	SH AO R T IH JH
SHOT	SH AA T
SHOULD	SH UH D
SHOW	SH OW
SHOWER	SH AW ER
SHRED	SH R EH D
SHRUGGED	SH R AH G D
SHUT	SH AH T
SHY	SH AY
SICKER	S IH K ER
SIDE	S AY D
SIERRA	S IY EH R AH
SIGH	S AY
SIGHT	S AY T
SIGN	S AY N
SILLY	S IH L IY
SILVERWARE	S IH L V ER W EH R
SIMPLE	S IH M P AH L
SIN	S IH N
SINCE	S IH N S
SING	S IH NG
SINGER'S	S IH NG ER Z
SINGLE	S IH NG G AH L
SINK	S IH NG K
SIP	S IH P
SISTER	S IH S T ER
SIT	S IH T
SITTER	S IH T ER
SITTING	S IH T IH NG
SITUATION	S IH CH UW EY SH AH N
SIX	S IH K S
SKETCH	S K EH CH
SKI	S K IY
SKILLFULLY	S K IH L F AH L IY
SKILLS	S K IH L Z
SKIP	S K IH P
SLAY	S L EY
SLEEP	S L IY P
SLICKER	S L IH K ER
SLID	S L IH D
SLIGHTLY	S L AY T L IY
SLIM	S L IH M
SLIP	S L IH P
SLOWLY	S L OW L IY
SLUMS	S L AH M Z
SMALL	S M AO L
SMOKE	S M OW K
SMOOTH	S M UW DH
SNAKE	S N EY K
SNOOP	S N UW P
SNORT	S N AO R T
SNOW	S N OW
SO	S OW
SOCIAL	S OW SH AH L
SOCIALIZED	S OW SH AH L AY Z D
SOLD	S OW L D
SOLICITS	S AH L IH S AH T S
SOME	S AH M
SOMEPLACE	S AH M P L EY S
SOMETHING	S AH M TH IH NG
SOON	S UW N
SORT	S AO R T
SOUL	S OW L
SOULS	S OW L Z
SOURCES	S AO R S AH Z
SPACE	S P EY S
SPADE	S P EY D
SPAIN	S P EY N
SPARK	S P AA R K
SPARSELY	S P AA R S L IY
SPEAK	S P IY K
SPEAKS	S P IY K S
SPENDING	S P EH N D IH NG
SPIT	S P IH T
SPLINTER	S P L IH N T ER
SPLIT	S P L IH T
SPORT	S P AO R T
SPRAIN	S P R EY N
SPRAY	S P R EY
SPREAD	S P R EH D
SPRING	S P ER IH NG
SPRING	S P R IH NG
SPRINKLE	S P R IH NG K AH L
SQUARED	S K W EH R D
STABLE	S T EY B AH L
STAFF	S T AE F
STAGECOACH	S T EY JH K OW CH
STALL	S T AO L
STANDBY	S T AE N D B AY
START	S T AA R T
STATE	S T EY T
STATES	S T EY T S
STATUS	S T AE T AH S
STATUS	S T EY T AH S
STEAK	S T EY K
STEEL	S T IY L
STEEP	S T IY P
STEER	S T IH R
STEPS	S T EH P S
STICK	S T IH K
STICKS	S T IH K S
STILL	S T IH L
STIMULATING	S T IH M Y AH L EY T IH NG
STOOD	S T UH D
STORE	S T AO R
STORM	S T AO R M
STRAIGHT	S T R EY T
STRANGE	S T R EY N JH
STRAW	S T R AO
STREET	S T R IY T
STRETCH	S T R EH CH
STRETCHER	S T R EH CH ER
STRIKE	S T R AY K
STRONG	S T R AO NG
STRONGLY	S T R AO NG L IY
STRUCTURES	S T R AH K CH ER Z
STRUGGLED	S T R AH G AH L D
STUBBLE	S T AH B AH L
STUDENTS	S T UW D AH N T S
STUDENTS'	S T UW D AH N T S
STUFF	S T AH F
SUBTRACT	S AH B T R AE K T
SUBTRACTION	S AH B T R AE K SH AH N
SUCCESS	S AH K S EH S
SUCH	S AH CH
SUDDENLY	S AH D AH N L IY
SUGGESTED	S AH G JH EH S T AH D
SUGGESTED	S AH G JH EH S T IH D
SUIT	S UW T
SUM	S AH M
SUN	S AH N
SUNSHINE	S AH N SH AY N
SUPER	S UW P ER
SUPPLIES	S AH P L AY Z
SUPPRESS	S AH P R EH S
SURE	SH UH R
SURROUNDS	S ER AW N D Z
SURVIVE	S ER V AY V
SWAM	S W AE M
SWARM	S W AO R M
SWAY	S W EY
SWEATERS	S W EH T ER Z
SWIFTLY	S W IH F T L IY
SWING	S W IH NG
SWORE	S W AO R
SYMBOLS	S IH M B AH L Z
TABLE	T EY B AH L
TAIL	T EY L
TAKE	T EY K
TAKES	T EY K S
TAKING	T EY K IH NG
TALKED	T AO K T
TALL	T AO L
TANGO	T AE NG G OW
TAP	T AE P
TASKS	T AE S K S
TAX-AIDED	T AE K S EY D IH D
TEA	T IY
TEACH	T IY CH
TEAM	T IY M
TELEPHONE	T EH L AH F OW N
TELL	T EH L
TEMPER	T EH M P ER
TENANT'S	T EH N AH N T S
TENDER	T EH N D ER
TERM	T ER M
THAN	DH AE N
THAN	DH AH N
THAT	DH AE T
THAT	DH AH T
THAT'S	DH AE T S
THE	DH AH
THE	DH IY
THEIR	DH EH R
THEM	DH AH M
THEM	DH EH M
THEMSELVES	DH AH M S EH L V Z
THEMSELVES	DH EH M S EH L V Z
THEN	DH EH N
THEORY	TH IH R IY
THEORY	TH IY ER IY
THERE	DH EH R
THEY	DH EY
THEY'LL	DH EY L
THIGH	TH AY
THINGS	TH IH NG Z
THINK	TH IH NG K
THINKS	TH IH NG K S
THINNER	TH IH N ER
THIS	DH IH S
THORN	TH AO R N
THOROUGHLY	TH ER OW L IY
THOSE	DH OW Z
THOUGH	DH OW
THOUGHT	TH AO T
THREAD	TH R EH D
THREAT	TH R EH T
THREE	TH R IY
THROUGH	TH R UW
THURSDAY'S	TH ER Z D EY Z
THURSDAY'S	TH ER Z D IY Z
TICKER	T IH K ER
TICKS	T IH K S
TIE	T AY
TILE	T AY L
TIMBER	T IH M B ER
TIME	T AY M
TIN	T IH N
TIP	T IH P
TIPS	T IH P S
TO	T AH
TO	T IH
TO	T UW
TOE	T OW
TOGETHER	T AH G EH DH ER
TOLD	T OW L D
TOO	T UW
TOOK	T UH K
TOOT	T UW T
TOP	T AA P
TOP	T AO P
TORE	T AO R
TORN	T AO R N
TORT	T AO R T
TOUCHDOWN	T AH CH D AW N
TOWARD	T AH W AO R D
TOWARD	T AO R D
TRACE	T R EY S
TRADE	T R EY D
TRADED	T R EY D IH D
TRADITIONAL	T R AH D IH SH AH N AH L
TRAIN	T R EY N
TRAIT	T R EY T
TRANSITION	T R AE N Z IH SH AH N
TRANSLATED	T R AE N S L EY T IH D
TRANSLATED	T R AE N Z L EY T AH D
TRAVEL	T R AE V AH L
TREAD	T R EH D
TREEHOUSE	T R IY HH AW S
TRESPASSERS	T R EH S P AE S ER Z
TRIBES	T R AY B Z
TRIED	T R AY D
TRIFLE	T R AY F AH L
TRIP	T R IH P
TRIPS	T R IH P S
TROOP	T R UW P
TROUBLE	T R AH B AH L
TRY	T R AY
TRYING	T R AY IH NG
TRYING	T R AY NG
TUG	T AH G
TWELFTH	T W EH L F TH
TWICE	T W AY S
TWILIGHT	T W AY L AY T
TWO	T UW
UNBEATABLE	AH N B IY T AH B AH L
UNDER	AH N D ER
UNFORTUNATELY	AH N F AO R CH AH N AH T L IY
UNFORTUNATELY	AH N F AO R CH UW N AH T L IY
UNIFORM	Y UW N AH F AO R M
UNINTERRUPTED	AH N IH N ER AH P T IH D
UNINTERRUPTED	AH N IH N T ER AH P T IH D
UNIT	Y UW N AH T
UNIT	Y UW N IH T
UNPLEASANT	AH N P L EH Z AH N T
UNSPECIFIED	AH N S P EH S AH F AY D
UP	AH P
UPBEAT	AH P B IY T
UPBRINGING	AH P B R IH NG IH NG
UPDATING	AH P D EY T IH NG
UPGRADE	AH P G R EY D
UPON	AH P AA N
URCHINS	ER CH AH N Z
URGED	ER JH D
URGENT	ER JH AH N T
US	AH S
US	Y UW EH S
USE	Y UW S
USE	Y UW Z
USED	Y UW Z D
USUALLY	Y UW ZH AH L IY
USUALLY	Y UW ZH AH W AH L IY
UTMOST	AH T M OW S T
VALENTINES	V AE L AH N T AY N Z
VALIDATED	V AE L AH D EY T AH D
VALUE	V AE L Y UW
VAMP	V AE M P
VAT	V AE T
VERY	V EH R IY
VICTOR	V IH K T ER
VITAL	V AY T AH L
VOCABULARY	V OW K AE B Y AH L EH R IY
VOCAL	V OW K AH L
VOICE	V OY S
VOLUNTEERED	V AA L AH N T IH R D
WACK	W AE K
WAGES	W EY JH AH Z
WAGES	W EY JH IH Z
WAIT	W EY T
WALK	W AA K
WALK	W AO K
WALKED	W AO K T
WALL	W AO L
WALLS	W AO L Z
WANT	W AA N T
WANT	W AO N T
WANTED	W AA N T AH D
WANTED	W AO N IH D
WANTED	W AO N T IH D
WARM	W AO R M
WART	W AO R T
WAS	W AA Z
WAS	W AH Z
WAS	W AO Z
WASH	W AA SH
WASTE	W EY S T
WATCHED	W AA CH T
WATCHED	W AO CH T
WATER	W AO T ER
WAVES	W EY V Z
WAX	W AE K S
WAY	W EY
WAYS	W EY Z
WE	W IY
WE'D	W IY D
WE'LL	W IH L
WE'LL	W IY L
WE'RE	W ER
WE'RE	W IH R
WE'RE	W IY R
WE'VE	W IY V
WEALTH	W EH L TH
WEAR	W EH R
WEAVE	W IY V
WEDDING	W EH D IH NG
WEED	W IY D
WEEDS	W IY D Z
WEEK	W IY K
WEEKEND	W IY K EH N D
WEEKEND	W IY K IH N D
WEEKS	W IY K S
WEEP	W IY P
WEIGHT	W EY T
WELCOME	W EH L K AH M
WELL	W EH L
WENT	W EH N T
WERE	W ER
WEREN'T	W ER AH N T
WEREN'T	W ER N T
WEST	W EH S T
WET	W EH T
WHAT	HH W AH T
WHAT	W AH T
WHEN	HH W EH N
WHEN	HH W IH N
WHEN	W EH N
WHEN	W IH N
WHERE	HH W EH R
WHERE	W EH R
WHILE	HH W AY L
WHILE	W AY L
WHIP	HH W IH P
WHIP	W IH P
WHISKY	HH W IH S K IY
WHISKY	W IH S K IY
WHITE	HH W AY T
WHITE	W AY T
WHITE-CAPPED	W AY T K AE P T
WHO	HH UW
WHOLE	HH OW L
WHOOP	HH W UW P
WHOOP	W UW P
WHY	HH W AY
WHY	W AY
WICKED	W IH K AH D
WICKER	W IH K ER
WIDE	W AY D
WIFE	W AY F
WILL	W AH L
WILL	W IH L
WILLING	W IH L IH NG
WIN	W IH N
WINDOW	W IH N D OW
WINE	W AY N
WINNERS	W IH N ER Z
WINTER	W IH N T ER
WIPE	W AY P
WIRE	W AY ER
WIRE	W AY R
WISE	W AY Z
WISH	W IH SH
WISHED	W IH SH T
WIT	W IH T
WITCH	W IH CH
WITH	W IH DH
WITH	W IH TH
WITTY	W IH T IY
WIVES	W AY V Z
WOE	W OW
WONDERFUL	W AH N D ER F AH L
WOOLEN	W UH L AH N
WORE	W AO R
WORK	W ER K
WORKING	W ER K IH NG
WORRY	W ER IY
WORSE	W ER S
WOULD	W UH D
WRAPPED	R AE P T
WRITE	R AY T
WRITTEN	R IH T AH N
XRAY	Z R EY
XXX	Z K S
YANKEE	Y AE NG K IY
YARD	Y AA R D
YARDS	Y AA R D Z
YEAR	Y IH R
YEAR'S	Y IH R Z
YEARS	Y ER Z
YEARS	Y IH R Z
YELL	Y EH L
YELLOW	Y EH L OW
YES	Y EH S
YET	Y EH T
YOU	Y UW
YOU'D	Y UH D
YOU'D	Y UW D
YOU'LL	Y UW L
YOU'RE	Y UH R
YOU'RE	Y UW R
YOUNG	Y AH NG
YOUR	Y AO R
YOUR	Y UH R
YOURSELF	Y AO R S EH L F
YOURSELF	Y ER S EH L F
YOURSELF	Y UH R S EH L F
ZERO	Z IH R OW
ZERO	Z IY R OW
ZEST	Z EH S T
ZIP	Z IH P
ZULU	Z UW L UW
!SIL	SIL
